21 23
0 0
0 0 0 0 0 0 0 0 0 0 0 0 0 0 0 0 0 0 0 0 0
0 1 1 1 1 1 1 1 1 1 1 1 1 1 1 1 1 1 1 1 0
0 1 3 3 3 3 3 3 3 3 3 3 3 3 3 3 3 3 3 1 0
0 1 3 2 2 3 2 2 2 2 2 2 2 2 2 2 2 2 3 1 0
0 1 3 2 2 3 2 2 2 2 2 2 5 2 5 2 2 2 3 1 0
0 1 3 3 2 3 2 2 2 2 2 2 2 2 2 2 2 2 3 1 0
0 1 3 2 2 2 2 2 2 2 2 2 2 2 2 2 2 2 3 1 0
0 1 3 2 2 5 5 5 2 2 2 5 5 5 5 5 5 2 3 1 0
0 1 3 2 2 3 3 3 2 2 2 3 3 3 3 3 3 2 3 1 0
0 1 3 2 2 3 3 3 3 3 3 2 2 2 2 2 2 2 3 1 0
0 1 3 2 2 2 2 2 2 2 2 2 2 5 2 2 2 2 3 1 0
0 1 3 2 2 2 5 2 5 2 2 2 2 2 2 2 2 2 3 1 0
0 1 3 2 2 2 2 2 2 2 3 3 3 3 3 2 2 2 3 1 0
0 1 3 2 3 3 3 3 3 2 2 2 5 2 2 2 2 2 3 1 0
0 1 3 2 3 2 2 3 2 2 2 3 2 2 2 2 2 2 3 1 0
0 1 3 2 3 2 5 3 2 5 2 3 2 2 2 2 2 2 3 1 0
0 1 3 2 2 2 2 3 2 2 2 3 2 5 2 5 2 2 3 1 0
0 1 3 2 2 3 2 3 3 3 3 3 3 3 2 2 2 2 3 1 0
0 1 3 2 2 3 2 2 2 2 2 6 2 5 2 2 2 2 3 1 0
0 1 3 2 5 3 2 2 2 2 2 7 2 2 2 2 2 2 3 1 0
0 1 3 3 3 3 3 3 3 3 3 3 3 3 3 3 3 3 3 1 0
0 1 1 1 1 1 1 1 1 1 1 1 1 1 1 1 1 1 1 1 0
0 0 0 0 0 0 0 0 0 0 0 0 0 0 0 0 0 0 0 0 0